############
#P.........#
#=========.#
#..........#
#.=========#
#..........#
#=========.#
#..........#
#==========#
#++++++++++#
#~~~~~~~~~~#
############